You find yourself chained to a wall in a dark, dank dungeon. You have no idea how you got here, but you should probably try to find a way out. You look up and you begin to devise an escape plan.

Dungeon Quest
An Interactive Fiction by Alex
Release 1 / Serial number 140317 / Inform 7 build 6G60 (I6/v6.32 lib 6/12N) SD

Dungeon
The Dungeon has crumbling stone walls and a dirt floor. There is a dark hallway extending west.

You can see a Dungeon Door, a leaflet, a brass key, a Shackles (closed), a Prisoner and Gold here.

>unlock door
You can't see any such thing.

>unlock Gold
What do you want to unlock Gold with?

* * *

You find yourself chained to a wall in a dark, dank dungeon. You have no idea how you got here, but you should probably try to find a way out. You look up and you begin to devise an escape plan.

Dungeon Quest
An Interactive Fiction by Alex
Release 1 / Serial number 140317 / Inform 7 build 6G60 (I6/v6.32 lib 6/12N) SD

Dungeon
The Dungeon has crumbling stone walls and a dirt floor. There is a dark hallway extending west.

You can see a Dungeon Door, a leaflet, a brass key, a Shackles (closed), a Prisoner and Gold here.

>talk to skeleton
That's not a verb I recognise.

>talk
That's not a verb I recognise.

>speak
I didn't understand that sentence.

>look at guard
You see nothing special about the Guard.

>look at skeleton
I don't think he has anything interesting to say to me

* * *

You find yourself chained to a wall in a dark, dank dungeon. You have no idea how you got here, but you should probably try to find a way out. You look up and you begin to devise an escape plan.

Dungeon Quest
An Interactive Fiction by Alex
Release 1 / Serial number 140317 / Inform 7 build 6G60 (I6/v6.32 lib 6/12N) SD

Dungeon
The Dungeon has crumbling stone walls and a dirt floor. There is a dark hallway extending west.

You can see a Dungeon Door, a leaflet, a brass key, a Shackles (closed), a Prisoner and Gold here.

>Take brass key
Taken.

>use brass key
That's not a verb I recognise.

>unlock
(the brass key with the brass key)
That doesn't seem to be something you can unlock.

>unlock skeleton
(with the brass key)
That doesn't seem to be something you can unlock.

* * *

You find yourself chained to a wall in a dark, dank dungeon. You have no idea how you got here, but you should probably try to find a way out. You look up and you begin to devise an escape plan.

Dungeon Quest
An Interactive Fiction by Alex
Release 1 / Serial number 140317 / Inform 7 build 6G60 (I6/v6.32 lib 6/12N) SD

Dungeon
The Dungeon has crumbling stone walls and a dirt floor. There is a dark hallway extending west.

You can see a Dungeon Door, a leaflet, a brass key, a Shackles (closed), a Prisoner and Gold here.

>unlock skeleton
What do you want to unlock the Skeleton with?

>brass key
(first taking the brass key)
That doesn't seem to be something you can unlock.

>take key
You already have that.

>unlock skeleton
(with the brass key)
That doesn't seem to be something you can unlock.

* * *

You find yourself chained to a wall in a dark, dank dungeon. You have no idea how you got here, but you should probably try to find a way out. You look up and you begin to devise an escape plan.

Dungeon Quest
An Interactive Fiction by Alex
Release 1 / Serial number 140317 / Inform 7 build 6G60 (I6/v6.32 lib 6/12N) SD

Dungeon
The Dungeon has crumbling stone walls and a dirt floor. There is a dark hallway extending west.

You can see a Dungeon Door, a leaflet, a brass key, a Shackles (closed), a Prisoner and Gold here.

>take gold
I can't reach the gold. I need to unlock this prisoner first.

>inventory
You are carrying nothing.

>unlock shackles
What do you want to unlock the Shackles with?

>brass key
(first taking the brass key)
You unlock the Shackles.

>take gold
Hoho! Look at all that gold

>inventory
You are carrying:
  a brass key

* * *

>take gold
I can't reach the gold. I need to unlock this prisoner first.

>unlock shackles
What do you want to unlock the Shackles with?

>key
(first taking the brass key)
You unlock the Shackles.

>take gold
You can't see any such thing.

>open shackles
You open the Shackles, revealing Gold.

* * *

>take gold
I can't reach the gold. I need to unlock this prisoner first.

>unlock prisoner
What do you want to unlock the Prisoner with?

>key
(first taking the brass key)
That doesn't seem to be something you can unlock.

>unlock shackles
(with the brass key)
You unlock the Shackles.

>take gold
Taken.

* * *

>take gold
I can't reach the gold. I need to unlock this prisoner first.

>take key
Taken.

>examine shackles
You see nothing special about the Shackles.

>look at shackles
You see nothing special about the Shackles.

* * *

You find yourself chained to a wall in a dark, dank dungeon. You have no idea how you got here, but you should probably try to find a way out. You look up and you begin to devise an escape plan.

Dungeon Quest
An Interactive Fiction by Alex
Release 1 / Serial number 140317 / Inform 7 build 6G60 (I6/v6.32 lib 6/12N) SD

Dungeon
The Dungeon has crumbling stone walls and a dirt floor. There is a dark hallway extending west.

You can see a Dungeon Door, a leaflet, a brass key, a Shackles (closed), a Prisoner and Gold here.

>talk to prisoner
Please help me

>unlock prisoner
What do you want to unlock the Prisoner with?

>brass key
(first taking the brass key)
That doesn't seem to be something you can unlock.

>unlock shackles
(with the brass key)
You unlock the Shackles.

>talk to prisoner
Thank you

>clear
(the brass key)
Nothing obvious happens.

>drop
(the brass key)
Dropped.

* * *

You find yourself chained to a wall in a dark, dank dungeon. You have no idea how you got here, but you should probably try to find a way out. You look up and you begin to devise an escape plan.

Dungeon Quest
An Interactive Fiction by Alex
Release 1 / Serial number 140317 / Inform 7 build 6G60 (I6/v6.32 lib 6/12N) SD

Dungeon
The Dungeon has crumbling stone walls and a dirt floor. There is a dark hallway extending west.

You can see a Dungeon Door, a leaflet, a brass key, a Shackles (closed), a Prisoner and Gold here.

>go left
You can't see any such thing.

>Go east
You can't go that way.

* * *

You find yourself chained to a wall in a dark, dank dungeon. You have no idea how you got here, but you should probably try to find a way out. You look up and you begin to devise an escape plan.

Dungeon Quest
An Interactive Fiction by Alex
Release 1 / Serial number 140317 / Inform 7 build 6G60 (I6/v6.32 lib 6/12N) SD

Dungeon
The Dungeon has crumbling stone walls and a dirt floor. There is a dark hallway extending west.

You can see a Dungeon Door, a leaflet, a brass key, a Shackles (closed), a Prisoner and Gold here.

>go west
Armory
This appears to be an armory. I should look around for weapons. There are dark hallways to the north, south, and west

You can see a Sword and a Shield here.

>go north
Sanctum
Some sort of religious room. Nothing here but an altar and a priest.

You can see a Priest and a Potion here.

>go north
You can't go that way.

>go south
Armory
This appears to be an armory. I should look around for weapons. There are dark hallways to the north, south, and west

You can see a Sword and a Shield here.

>go south
Dark\ Room
A Dark Room. It's kind of scary. The darkness extends north, east, and south.

>go south
Cell
A cell with a sickly looking prisoner inside.

You can see a Cursed Man and an iron key here.

>go south
You can't go that way.

>go north
Dark\ Room
A Dark Room. It's kind of scary. The darkness extends north, east, and south.

>go west
You can't go that way.

>go east
Creepy\ Room
This room looks the same as the last one. The hallway continues into the darkness east and west.

You can see a Cross here.

>go east
Darker\ Room
This room is even darker than the last one.

You can see a Guard here.

>go north
Darkest\ Room
Wow. It's really dark in here.

>go north
Stable
How is there a stable underground in a dungeon?

You can see a Horse here.

>go south
Darkest\ Room
Wow. It's really dark in here.

>go south
Darker\ Room
This room is even darker than the last one.

You can see a Guard here.

>go sotuh
You can't see any such thing.

>go south
Guard\ Room
The room guarded by the Guard. Looks like there are a bunch of important looking locked doors here.

>go east
Study
This is nice. I'm glad that whoever built this dungeon takes the time to study.

You can see a silver key here.

>go west
Guard\ Room
The room guarded by the Guard. Looks like there are a bunch of important looking locked doors here.

>go west
Treasury
Holy cow! Look at all this gold that I can't take!

You can see a steel key here.

* * *

>go west
Armory
This appears to be an armory. I should look around for weapons. There are dark hallways to the north, south, and west

You can see a Sword and a Shield here.

>go south
Dark\ Room
A Dark Room. It's kind of scary. The darkness extends north, east, and south.

>go east
Creepy\ Room
This room looks the same as the last one. The hallway continues into the darkness east and west.

You can see a Cross here.

>take cross
Taken.

>go west
Dark\ Room
A Dark Room. It's kind of scary. The darkness extends north, east, and south.

>go north
Armory
This appears to be an armory. I should look around for weapons. There are dark hallways to the north, south, and west

You can see a Sword and a Shield here.

>go north
Sanctum
Some sort of religious room. Nothing here but an altar and a priest.

You can see a Priest and a Potion here.

>talk to priest
Oh, you have the cross! Would you trade the cross with me?

>trade cross with priest
Bless you child. Here, take this. It will serve you better than I.

[Your score has just gone up by five points.]

>take potion
Taken.

* * *

>go east
Darker\ Room
This room is even darker than the last one.

You can see a Guard here.

>kill guard
Violence isn't the answer to this one.

>go west
Creepy\ Room
This room looks the same as the last one. The hallway continues into the darkness east and west.

You can see a Cross here.

>go west
Dark\ Room
A Dark Room. It's kind of scary. The darkness extends north, east, and south.

* * *

>go north
Armory
This appears to be an armory. I should look around for weapons. There are dark hallways to the north, south, and west

You can see a Sword and a Shield here.

>take sword
Taken.

>go south
Dark\ Room
A Dark Room. It's kind of scary. The darkness extends north, east, and south.

* * *

>kill guard
Violence isn't the answer to this one.

>kill
(the Sword)
Violence isn't the answer to this one.

>kill guard with sword
I only understood you as far as wanting to kill the Guard.

>kill the guard
Violence isn't the answer to this one.

>kill the sword with the guard
I only understood you as far as wanting to kill the Sword.

* * *

>go south
Dark\ Room
A Dark Room. It's kind of scary. The darkness extends north, east, and south.

>go west
You can't go that way.

>talk to guard
You can't see any such thing.

* * *

>go west
Armory
This appears to be an armory. I should look around for weapons. There are dark hallways to the north, south, and west

You can see a Sword and a Shield here.

>take sword
[Your score has just gone up by five points.]

>go south
Dark\ Room
A Dark Room. It's kind of scary. The darkness extends north, east, and south.

* * *

>go east
Darker\ Room
This room is even darker than the last one.

You can see a Guard here.

>go south
The guard refuses to let you pass.

>kill guard with sword
(first taking the Guard)
I don't suppose the Guard would care for that.

>kill the guard
Violence isn't the answer to this one.

* * *

>go east
Darker\ Room
This room is even darker than the last one.

You can see a Guard here.

>kill guard
(with the Sword)
(first taking the Guard)
I don't suppose the Guard would care for that.

>attack
(the Sword)
Violence isn't the answer to this one.

>kill
(the Sword with the Sword)
The guard's axe comes crashing down on your shieldless arm. Blood sprays everywhere, and the world turns black.

    *** You have died ***

In that game you scored 0 out of a possible 0, in 8 turns.

Would you like to RESTART, RESTORE a saved game, QUIT or UNDO the last command?

* * *

>take sword
[Your score has just gone up by five points.]

>take shield
[Your score has just gone up by five points.]

>go south
Dark\ Room
A Dark Room. It's kind of scary. The darkness extends north, east, and south.

* * *

>go east
Darker\ Room
This room is even darker than the last one.

You can see a Guard here.

>trade gold with guard
You can't see any such thing.

>trade guard
You can't see any such thing.

>trade gold
You can't see any such thing.

>trade
What do you want to trade?

>go west
Creepy\ Room
This room looks the same as the last one. The hallway continues into the darkness east and west.

You can see a Cross here.

* * *

>go west
Dark\ Room
A Dark Room. It's kind of scary. The darkness extends north, east, and south.

>go north
Armory
This appears to be an armory. I should look around for weapons. There are dark hallways to the north, south, and west

>go east
Dungeon
The Dungeon has crumbling stone walls and a dirt floor. There is a dark hallway extending west.

You can see a Dungeon Door, a leaflet, a brass key, a Shackles (closed), a Prisoner and Gold here.

>take key
Taken.

>unlock shackles
What do you want to unlock the Shackles with?

>key
You unlock the Shackles.

>take gold
Taken.

>go west
Armory
This appears to be an armory. I should look around for weapons. There are dark hallways to the north, south, and west

>go south
Dark\ Room
A Dark Room. It's kind of scary. The darkness extends north, east, and south.

* * *

>go north
Armory
This appears to be an armory. I should look around for weapons. There are dark hallways to the north, south, and west

>go north
Sanctum
Some sort of religious room. Nothing here but an altar and a priest.

You can see a Priest and a Potion here.

>trade potion
You can't see any such thing.

>trade potion with priest
You can't see any such thing.

>trade cross with priest
Bless you child. Here, take this. It will serve you better than I.

[Your score has just gone up by five points.]

* * *

>take potion
Taken.

>go south
Armory
This appears to be an armory. I should look around for weapons. There are dark hallways to the north, south, and west

>go sotuh
You can't see any such thing.

>go south
Dark\ Room
A Dark Room. It's kind of scary. The darkness extends north, east, and south.

* * *

>go south
Cell
A cell with a sickly looking prisoner inside.

You can see a Cursed Man and an iron key here.

>trade potion with cursed man
Thank you so much for the potion. I really needed that. Here, have this. I found it wandering around looking for a cure.

[Your score has just gone up by five points.]

>take key
(the iron key)
Taken.

>go north
Dark\ Room
A Dark Room. It's kind of scary. The darkness extends north, east, and south.

>go east
Creepy\ Room
This room looks the same as the last one. The hallway continues into the darkness east and west.

>go east
Darker\ Room
This room is even darker than the last one.

You can see a Guard here.

* * *

>go south
The guard refuses to let you pass.

>trade gold with guard
Thanks for the gold kid. Feel free to pass. I won't tell.

[Your score has just gone up by five points.]

>go south
Guard\ Room
The room guarded by the Guard. Looks like there are a bunch of important looking locked doors here.

You can see a Wooden Door and a Mahogany Door here.

>unlock wooden door
What do you want to unlock the Wooden Door with?

>wooden key
I only understood you as far as wanting to unlock the Wooden Door with the Wooden Door.

>inventory
You are carrying:
  an iron key
  a brass key
  a Shield
  a Sword

>go north
Darker\ Room
This room is even darker than the last one.

You can see a Guard here.

>go north
Darkest\ Room
Wow. It's really dark in here.

You can see a wooden key here.

>take key
(the wooden key)
Taken.

>go south
Darker\ Room
This room is even darker than the last one.

You can see a Guard here.

>go south
Guard\ Room
The room guarded by the Guard. Looks like there are a bunch of important looking locked doors here.

You can see a Wooden Door and a Mahogany Door here.

* * *

>unlock wooden door
What do you want to unlock the Wooden Door with?

>wooden key
You unlock the Wooden Door.

>go west
(first opening the Mahogany Door)

Treasury
Holy cow! Look at all this gold that I can't take!

You can see a Mahogany Door and a steel key here.

>go west
You can't go that way.

>go east
Guard\ Room
The room guarded by the Guard. Looks like there are a bunch of important looking locked doors here.

You can see a Mahogany Door and a Wooden Door here.

>go east
(first opening the Wooden Door)

Study
This is nice. I'm glad that whoever built this dungeon takes the time to study.

You can see a Wooden Door and a silver key here.

* * *

You find yourself chained to a wall in a dark, dank dungeon. You have no idea how you got here, but you should probably try to find a way out. You look up and you begin to devise an escape plan.

Dungeon Quest
An Interactive Fiction by Alex
Release 1 / Serial number 140317 / Inform 7 build 6G60 (I6/v6.32 lib 6/12N) SD

Dungeon
The Dungeon has crumbling stone walls and a dirt floor. There is a dark hallway extending west.

You can see a Dungeon Door, a leaflet, a brass key, a Shackles (closed), a Prisoner and Gold here.

>examine shackles
These look like they need a key to unlock them.

>take key
Taken.

>unlock shackles
(with the brass key)
You unlock the Shackles.

>examine shackles
Some metal chains just lying around.

>take leaflet
Taken.

>read leafklet
You can't see any such thing.

>read leaflet
Good luck trying to get out of here. Your buddy next to you thought he could get out too. Mwahaha!

>talk to prisoner
Thank you

>look
Dungeon
The Dungeon has crumbling stone walls and a dirt floor. There is a dark hallway extending west.

You can see a Shackles (closed), a Prisoner and Gold here.

>open shackles
You open the Shackles.

>take gold
Taken.

>go east
You can't go that way.

>go west
Armory
This appears to be an armory. I should look around for weapons. There are dark hallways to the north, south, and west

You can see a Sword and a Shield here.

>take sword
Taken.

>take
(the Shield)
Taken.

>go north
Sanctum
Some sort of religious room. Nothing here but an altar and a priest.

You can see a Priest and a Potion here.

>take potion
I can't take this until I give the priest the cross

* * *

You find yourself chained to a wall in a dark, dank dungeon. You have no idea how you got here, but you should probably try to find a way out. You look up and you begin to devise an escape plan.

Dungeon Quest
An Interactive Fiction by Alex
Release 1 / Serial number 140317 / Inform 7 build 6G60 (I6/v6.32 lib 6/12N) SD

Dungeon
The Dungeon has crumbling stone walls and a dirt floor. There is a dark hallway extending west.

You can see a Dungeon Door, a leaflet, a brass key, a Shackles (closed), a Prisoner and Gold here.

>unlock shackles with ke
You can't see any such thing.

>unlock shackles with key
(first taking the brass key)
You unlock the Shackles.

>take gold
Taken.

>go west
Armory
This appears to be an armory. I should look around for weapons. There are dark hallways to the north, south, and west

You can see a Sword and a Shield here.

>take
What do you want to take?

>sword
Taken.

>take
(the Shield)
Taken.

* * *

>go north
Sanctum
Some sort of religious room. Nothing here but an altar and a priest.

You can see a Priest and a Potion here.

>talk to priest
Please, I have lost my Cross in this forsaken dungeon. I can give you this potion if you find it for me.

>go south
Armory
This appears to be an armory. I should look around for weapons. There are dark hallways to the north, south, and west

>go south
Dark\ Room
A Dark Room. It's kind of scary. The darkness extends north, east, and south.

* * *

>talk to priest
Oh, you have the cross! Would you trade the cross with me?

>take potion
I can't take this until I give the priest the cross

>trade cross with priest
Bless you child. Here, take this. It will serve you better than I.

[Your score has just gone up by five points.]

>take potion
I can't take this until I give the priest the cross

* * *

You find yourself chained to a wall in a dark, dank dungeon. You have no idea how you got here, but you should probably try to find a way out. You look up and you begin to devise an escape plan.

Dungeon Quest
An Interactive Fiction by Alex
Release 1 / Serial number 140317 / Inform 7 build 6G60 (I6/v6.32 lib 6/12N) SD

Dungeon
The Dungeon has crumbling stone walls and a dirt floor. There is a dark hallway extending west.

You can see a Dungeon Door, a leaflet, a brass key, a Shackles (closed), a Prisoner and Gold here.

>kill
What do you want to kill?

>kill guard
You can't see any such thing.

* * *

You find yourself chained to a wall in a dark, dank dungeon. You have no idea how you got here, but you should probably try to find a way out. You look up and you begin to devise an escape plan.

Dungeon Quest
An Interactive Fiction by Alex
Release 1 / Serial number 140317 / Inform 7 build 6G60 (I6/v6.32 lib 6/12N) SD

Dungeon
The Dungeon has crumbling stone walls and a dirt floor. There is a dark hallway extending west.

You can see a Dungeon Door, a leaflet, a brass key, a Shackles (closed), a Prisoner and Gold here.

>open door
You can't see any such thing.

>open
What do you want to open?

* * *

You find yourself chained to a wall in a dark, dank dungeon. You have no idea how you got here, but you should probably try to find a way out. You look up and you begin to devise an escape plan.

Dungeon Quest
An Interactive Fiction by Alex
Release 1 / Serial number 140317 / Inform 7 build 6G60 (I6/v6.32 lib 6/12N) SD

Dungeon
The Dungeon has crumbling stone walls and a dirt floor. There is a dark hallway extending west.

You can see a Dungeon Door, a leaflet, a brass key, a Shackles (closed), a Prisoner and Gold here.

>go east
You can't go that way.

* * *

>take sword
Taken.

>go north
Sanctum
Some sort of religious room. Nothing here but an altar and a priest.

You can see a Priest and a Potion here.

* * *

>take potion
Taken.

>go south
Armory
This appears to be an armory. I should look around for weapons. There are dark hallways to the north, south, and west

You can see a Shield here.

>go south
Dark\ Room
A Dark Room. It's kind of scary. The darkness extends north, east, and south.

* * *

>go south
Cell
A cell with a sickly looking prisoner inside.

You can see a Cursed Man and an iron key here.

>take iron key
I need to find the potion first

>trade potion with cursed man
Thank you so much for the potion. I really needed that. Here, have this. I found it wandering around looking for a cure.

[Your score has just gone up by five points.]

>take key
Taken.

>inventory
You are carrying:
  an iron key
  a Sword

>go north
Dark\ Room
A Dark Room. It's kind of scary. The darkness extends north, east, and south.

* * *

>kill guard
Violence isn't the answer to this one.

>kill guard with sword
(first taking the Guard)
I don't suppose the Guard would care for that.

>kill guard
Violence isn't the answer to this one.

* * *

>go south
Dark\ Room
A Dark Room. It's kind of scary. The darkness extends north, east, and south.

>go eas
You can't see any such thing.

>go west
You can't go that way.

>go north
Armory
This appears to be an armory. I should look around for weapons. There are dark hallways to the north, south, and west

You can see a Sword and a Shield here.

>go east
Dungeon
The Dungeon has crumbling stone walls and a dirt floor. There is a dark hallway extending west.

You can see a Dungeon Door, a leaflet, a brass key, a Shackles (closed), a Prisoner and Gold here.

* * *

>unlock shackles
(with the brass key)
You unlock the Shackles.

>go north
(first opening the Dungeon Door)
You can't open the door

>take gold
Taken.

* * *

>take cross
Taken.

>go east
Darker\ Room
This room is even darker than the last one.

You can see a Guard here.

>trade gold with guard
Thanks for the gold kid. Feel free to pass. I won't tell.

[Your score has just gone up by five points.]

* * *

>go south
Guard\ Room
The room guarded by the Guard. Looks like there are a bunch of important looking locked doors here.

You can see a Wooden Door and a Mahogany Door here.

>go east
(first opening the Wooden Door)
It seems to be locked.

>go north
Darker\ Room
This room is even darker than the last one.

You can see a Guard here.

* * *

>go south
Guard\ Room
The room guarded by the Guard. Looks like there are a bunch of important looking locked doors here.

You can see a Wooden Door and a Mahogany Door here.

>unlock wooden door with wooden key
You unlock the Wooden Door.

>go east
(first opening the Wooden Door)

Study
This is nice. I'm glad that whoever built this dungeon takes the time to study.

You can see a Wooden Door and a silver key here.

>take silver key
Taken.

>go west
Guard\ Room
The room guarded by the Guard. Looks like there are a bunch of important looking locked doors here.

You can see a Wooden Door and a Mahogany Door here.

>go north
Darker\ Room
This room is even darker than the last one.

You can see a Guard here.

>go north
Darkest\ Room
Wow. It's really dark in here.

* * *

>go north
Stable
How is there a stable underground in a dungeon?

You can see a Horse here.

>unlock horse
What do you want to unlock the Horse with?

>silver key
That doesn't seem to be something you can unlock.

>talk to horse
You free the horse!

[Your score has just gone up by one hundred points.]

>go south
Darkest\ Room
Wow. It's really dark in here.

* * *

>go south
Darker\ Room
This room is even darker than the last one.

You can see a Guard here.

>go west
Creepy\ Room
This room looks the same as the last one. The hallway continues into the darkness east and west.

>go west
Dark\ Room
A Dark Room. It's kind of scary. The darkness extends north, east, and south.

* * *

>go north
Sanctum
Some sort of religious room. Nothing here but an altar and a priest.

You can see a Priest and a Potion here.

>trade cross with priest
Bless you child. Here, take this. It will serve you better than I.

[Your score has just gone up by five points.]

* * *

>trade potion with cursed man
Thank you so much for the potion. I really needed that. Here, have this. I found it wandering around looking for a cure.

[Your score has just gone up by five points.]

>go north
Dark\ Room
A Dark Room. It's kind of scary. The darkness extends north, east, and south.

* * *

>go east
Darker\ Room
This room is even darker than the last one.

You can see a Guard here.

>go south
Guard\ Room
The room guarded by the Guard. Looks like there are a bunch of important looking locked doors here.

You can see a Wooden Door and a Mahogany Door here.

>unlock mahogany door with steel key
You can't see any such thing.

>inventory
You are carrying:
  a wooden key
  a Shield
  a Sword
  a brass key

>go north
Darker\ Room
This room is even darker than the last one.

You can see a Guard here.

>go west
Creepy\ Room
This room looks the same as the last one. The hallway continues into the darkness east and west.

* * *

>go west
Dark\ Room
A Dark Room. It's kind of scary. The darkness extends north, east, and south.

>go south
Cell
A cell with a sickly looking prisoner inside.

You can see a Cursed Man and an iron key here.

>take key
(the iron key)
Taken.

* * *

>go south
Guard\ Room
The room guarded by the Guard. Looks like there are a bunch of important looking locked doors here.

You can see a Wooden Door and a Mahogany Door here.

>unlock mahogany door with iron key
You unlock the Mahogany Door.

>go west
(first opening the Mahogany Door)

Treasury
Holy cow! Look at all this gold that I can't take!

You can see a Mahogany Door and a steel key here.

>take steel key
Taken.

>go east
Guard\ Room
The room guarded by the Guard. Looks like there are a bunch of important looking locked doors here.

You can see a Mahogany Door and a Wooden Door here.

>go north
Darker\ Room
This room is even darker than the last one.

You can see a Guard here.

* * *

>go north
Armory
This appears to be an armory. I should look around for weapons. There are dark hallways to the north, south, and west

>go east
Dungeon
The Dungeon has crumbling stone walls and a dirt floor. There is a dark hallway extending west.

You can see a Dungeon Door, a leaflet, a Shackles (closed) and a Prisoner here.

>go north
(first opening the Dungeon Door)
The light pours into the cell. You ride out on your majestic steed into the sunset.

    *** You have won ***

In that game you scored 125 out of a possible 0, in 70 turns.

Would you like to RESTART, RESTORE a saved game, QUIT or UNDO the last command?

* * *

You find yourself chained to a wall in a dark, dank dungeon. You have no idea how you got here, but you should probably try to find a way out. You look up and you begin to devise an escape plan.

Dungeon Quest
An Interactive Fiction by Alex
Release 1 / Serial number 140317 / Inform 7 build 6G60 (I6/v6.32 lib 6/12N) SD

Dungeon
The Dungeon has crumbling stone walls and a dirt floor. There is a dark hallway extending west.

You can see a Dungeon Door, a leaflet, a brass key, a Shackles (closed), a Prisoner and Gold here.

>run
You'll have to say which compass direction to go in.

>ask
What do you want to ask the Prisoner for?

>vomit
You can't see any such thing.

>sit
What do you want to sit on?

>trip
You can't see any such thing.

>kill
What do you want to kill?

>prisoner
Violence isn't the answer to this one.